ATP	ADP
adenosine triphosphate	adenosine diphosphate
ATP	AMP
adenosine triphosphate	adenosine monophosphate
NADH	NAD
NADPH	NADP(+)
FADH2	FAD
TRX1	TRX1 disulphide
Ala-tRNA(Ala)	tRNA(Ala)
Arg-tRNA(Arg)	tRNA(Arg)
Arg-tRNA(Arg)	tRNA(Arg)
Asn-tRNA(Asn)	tRNA(Asn)
Asp-tRNA(Asp)	tRNA(Asp)
Cys-tRNA(Cys)	tRNA(Cys)
Gln-tRNA(Gln)	tRNA(Gln)
Glu-tRNA(Glu)	tRNA(Glu)
Gly-tRNA(Gly)	tRNA(Gly)
His-tRNA(His)	tRNA(His)
Glycyl-tRNA(Ala)	tRNA(Ala)
Ile-tRNA(Ile)	tRNA(Ile)
Leu-tRNA(Leu)	tRNA(Leu)
Lys-tRNA(Lys)	tRNA(Lys)
Met-tRNA(Met)	tRNA(Met)
Phe-tRNA(Phe)	tRNA(Phe)
Pro-tRNA(Pro)	tRNA(Pro)
Ser-tRNA(Ser)	tRNA(Ser)
Thr-tRNA(Thr)	tRNA(Thr)
Trp-tRNA(Trp)	tRNA(Trp)
Tyr-tRNA(Tyr)	tRNA(Tyr)
D-tyrosyl-tRNA(Tyr)	tRNA(Tyr)
Val-tRNA(Val)	tRNA(Val)
ferricytochrome c	ferrocytochrome c
Ferricytochrome b5	Ferrocytochrome b5
